1 10 10091 10082 10046 10011 9992 9979 9954 9949 9944 9943 
1 6 9678 3440 9633 9646 1302 9600 
1 4 9600 9628 9652 9676 
1 7 3167 4655 10190 903 1526 10074 10025 
1 6 10025 4667 10042 4055 562 10091 
1 7 10091 10124 2331 10200 10217 4655 3167 
1 9 10025 10002 9965 9917 5136 9802 9773 5301 9678 
1 12 9676 9695 9712 9753 3916 2096 4244 9878 9914 3429 9913 9943 
1 9 10025 1991 9932 9904 9861 4993 9747 9717 9676 
1 7 9061 9002 8924 8868 8764 8686 2010 
1 8 4005 2801 4405 3629 8868 8924 9002 9061 
1 4 2010 8557 4774 4005 
1 6 4005 4105 8346 8373 823 8316 
1 7 2010 8576 5068 2199 8372 8315 8253 
1 4 8253 8143 3281 1756 
1 4 1756 365 2036 4497 
1 6 4497 7803 7763 7652 5151 7621 
1 6 7621 7569 3500 2525 7306 7307 
1 6 7621 7687 7793 2489 5105 1756 
1 8 1756 4676 8071 8133 4162 3163 823 8316 
1 5 7970 2686 5022 2372 8316 
1 8 7970 7969 8028 7991 706 7978 7917 4497 
1 3 8028 8050 8071 
1 6 7886 3442 492 8035 1958 8166 
1 6 8166 1958 8089 8052 8051 8003 
1 4 8003 960 3442 7886 
1 9 8003 3184 1767 8163 8122 2177 8017 4464 7970 
1 5 8327 1543 5129 2679 2010 
1 5 8327 4527 4927 8115 1756 
1 4 8327 8319 2335 8253 
1 3 8327 5080 8346 
